..............
..............
..............
..............
..............
..............
..............
.............#
.........^....
##############